p.b.-.-.b.p.p.b.-.-
b.e.-.b.p.p.b.-.g.-
-.b.-.b.p.p.b.-.-.-
b.p.b.-.b.b.-.q.-.-
p.b.-.-.-.-.q.m.q.-
b.-.s.-.-.-.b.bq.-.-
-.s.w.s.l.b.p.p.b.-
-.-.s.l.h.l.b.gb.b.-
-.-.-.-.l.-.-.b.p.p
-.-.-.-.-.-.-.-.b.-
