10
P.-.-.-.P.P.-.-.-.-
-.A.-.-.P.P.-.-.G.-
-.-.-.-.P.P.-.-.-.-
-.P.-.-.-.-.-.-.-.-
P.-.-.-.-.-.-.P_G.-.-
-.-.-.-.-.-.-.-.-.-
-.-.W.-.-.-.P.P.-.-
-.-.-.-.H_P.-.-.G.-.-
-.W.-.-.-.-.-.-.P.-
-.-.-.-.-.-.-.-.-.-
