10
-.W.W.W.W.W.W.W.W.W
W.W.W.W.W.W.W.W.W.W
W.W.W.W.W.W.W.W.W.W
W.W.W.W.W.W.W.W.W.W
W.W.W.W.W.W.W.W.W.W
W.W.W.W.W.W.W.W.W.W
W.W.W.W.W.W.P.P.W.W
W.W.W.W.W.W.P.G.G.G
W.W.W.W.W.W.P.G.G.G
W.W.W.W.W.W.P.G.G.G